tilesetIso.png 7 32 16
CAMINHAVEL 1 3 6
15 15
4 4 4 4 4 4 4 4 4 4 4 4 4 4 4
4 1 1 1 1 1 1 1 1 1 1 1 1 1 4
4 1 2 2 2 2 1 1 1 1 1 1 1 1 4
4 1 2 2 2 2 1 1 3 3 3 1 1 1 4
4 1 1 1 1 1 1 1 3 3 3 1 1 1 4
4 1 1 1 1 1 1 1 1 1 1 1 1 1 4
4 1 1 1 1 3 3 3 3 3 1 1 1 1 4
4 1 1 1 1 3 3 3 3 3 1 1 1 1 4
4 1 1 1 1 1 1 1 1 1 1 1 1 1 4
4 1 1 1 1 1 1 1 1 1 1 2 2 1 5
4 1 1 1 1 1 1 1 1 1 1 2 2 1 4
4 1 1 1 1 1 1 1 6 1 1 1 1 1 4
4 1 3 3 3 1 1 1 1 1 1 1 1 1 4
4 1 3 3 3 1 1 1 1 1 1 1 1 1 4
4 4 4 4 4 4 4 4 4 4 4 4 4 4 4
OBJETOS
MOEDA 2 8
MOEDA 5 12
MOEDA 10 3
SAIDA 13 13