tilesetIso.png 7 32 16
CAMINHAVEL 1 3
15 15
3 3 3 3 3 3 3 3 3 3 3 3 3 3 3
3 1 1 1 1 1 1 1 1 1 1 1 1 1 3
3 1 2 2 2 2 1 1 1 1 1 1 1 1 3
3 1 2 2 2 2 1 1 3 3 3 1 1 1 3
3 1 1 1 1 1 1 1 3 3 3 1 1 1 3
3 1 1 1 1 1 1 1 1 1 1 1 1 1 3
3 1 1 1 1 3 3 3 3 3 1 1 1 1 3
3 1 1 1 1 3 3 3 3 3 1 1 1 1 3
3 1 1 1 1 1 1 1 1 1 1 1 1 1 3
3 1 1 1 1 1 1 1 1 1 1 2 2 1 3
3 1 1 1 1 1 1 1 1 1 1 2 2 1 3
3 1 1 1 1 1 1 1 1 1 1 1 1 1 3
3 1 3 3 3 1 1 1 1 1 1 1 1 1 3
3 1 3 3 3 1 1 1 1 1 1 1 1 1 3
3 3 3 3 3 3 3 3 3 3 3 3 3 3 3
OBJETOS
MOEDA 2 8
MOEDA 5 12
MOEDA 10 3
LAVA 6 6
SAIDA 13 13